1101,1101,1101,1101,1101,1101,1101,1101,1101,1101,
1101,1101,1101,1101,1101,1101,1101,1101,1101,1101,
1101,1101,1101,1101,1101,1101,1101,1101,1101,1101,
1101,1101,1101,1101,1101,1101,1101,1101,1101,1101,
1101,1101,1101,1101,1101,1101,1101,1101,1101,1101,
1101,1101,1101,1101,1101,1101,1101,1101,1101,1101,
1101,1101,1101,1102,1102,1103,1102,1102,1101,1101,
1101,1101,1104,1101,1101,1101,1101,1101,1105,1101,
1101,1101,1101,1101,1101,1101,1101,1101,1101,1101,
1101,1101,1101,1101,1101,1101,1101,1101,1101,1101,
1101,1101,1101,1101,1101,1101,1101,1101,1101,1101,
1101,1101,1101,1101,1101,1101,1101,1101,1101,1101,
1101,1101,1101,1101,1101,1101,1101,1101,1101,1101,
1101,1101,1101,1101,1101,1101,1101,1101,1101,1101,
1101,1101,1101,1101,1101,1101,1101,1101,1101,1101,
1101,1101,1101,1101,1101,1101,1101,1101,1101,1101,
1101,1101,1101,1101,1101,1101,1101,1101,1101,1101,
1101,1101,1101,1101,1101,1101,1101,1101,1101,1101,
1101,1101,1101,1101,1101,1101,1101,1101,1101,1101,
1101,1101,1101,1101,1101,1101,1101,1101,1101,1101,
1101,1101,1101,1101,1101,1101,1101,1101,1101,1101,
1101,1101,1106,1101,1101,1101,1101,1101,1101,1101,
1101,1101,1101,1101,1101,1101,1101,1101,1101,1101,
1101,1101,1101,1101,1101,1101,1107,1101,1101,1101,
1101,1101,1101,1101,1101,1101,1101,1101,1101,1101,
1101,1101,1101,1101,1101,1101,1101,1101,1101,1101,
1101,1101,1101,1101,1101,1101,1101,1101,1101,1101,
1101,1101,1101,1101,1101,1101,1101,1101,1101,1101,
1101,1101,1101,1101,1101,1101,1101,1101,1101,1101,
1101,1101,1101,1101,1101,1101,1101,1101,1101,1101,
1101,1101,1101,1101,1101,1101,1101,1101,1101,1101,
1101,1101,1101,1101,1101,1101,1101,1101,1101,1101,
1101,1101,1101,1101,1101,1101,1101,1101,1101,1101,
1101,1101,1101,1101,1101,1101,1101,1101,1101,1101,
1101,1101,1101,1101,1101,1101,1101,1101,1101,1101,
1101,1101,1101,1101,1101,1101,1101,1101,1101,1101,
1101,1101,1101,1101,1101,1101,1101,1101,1101,1101,
1101,1101,1101,1101,1101,1101,1101,1101,1101,1101,
1101,1101,1101,1101,1101,1101,1101,1101,1101,1101,
1101,1101,1101,1101,1101,1101,1108,1101,1101,1101,
1101,1101,1101,1101,1101,1101,1101,1101,1101,1101,
1101,1101,1101,1109,1101,1101,1101,1101,1101,1101,
1101,1101,1101,1101,1101,1101,1101,1101,1101,1101,
1101,1101,1101,1101,1101,1101,1101,1101,1101,1101,
1101,1101,1101,1101,1101,1101,1101,1101,1101,1101,
1101,1101,1101,1101,1101,1101,1101,1101,1101,1101,
1101,1101,1101,1101,1101,1101,1101,1101,1101,1101,
1101,1101,1101,1101,1101,1101,1101,1101,1101,1101,
1101,1101,1101,1101,1101,1101,1101,1101,1101,1101,
1101,1101,1101,1101,1101,1101,1101,1101,1101,1101